Abkhazia	normal
Afghanistan	poor
Albania	normal
Algeria_Coast	small
Andorra	high
Angola	small
Anguilla	high
Antarctica	extra_small
Antigua and Barbuda	high
Argentina_Buenos Aires_Buenos Aires	high
Argentina_Buenos Aires_North	normal
Argentina_Buenos Aires_South	normal
Argentina_Cuyo	poor
Argentina_Mesopotamia	normal
Argentina_Northwest	poor
Argentina_Pampas	extra_small
Argentina_Patagonia	poor
Argentina_Santa Fe	normal
Armenia	normal
Australia_Brisbane	small
Australia_Melbourne	high
Australia_New South Wales	poor
Australia_Northern Territory	small
Australia_Queensland	small
Australia_South Australia	poor
Australia_Sydney	small
Australia_Tasmania	small
Australia_Victoria	extra_small
Australia_Western Australia	small
Austria_Burgenland	high
Austria_Carinthia	high_f2
Austria_Lower Austria_West	high
Austria_Lower Austria_Wien	high
Austria_Salzburg	high_f2
Austria_Styria_Graz	high
Austria_Styria_Leoben	normal
Austria_Tyrol	normal
Austria_Upper Austria_Linz	high
Austria_Upper Austria_Wels	high
Austria_Vorarlberg	high
Azerbaijan	small
Bahrain	high
Bangladesh	normal
Barbados	high
Belarus_Brest Region	high_f2
Belarus_Homiel Region	high_f2
Belarus_Hrodna Region	high
Belarus_Maglieu Region	high_f2
Belarus_Minsk Region	normal
Belarus_Vitebsk Region	normal
Belgium_Antwerp	high
Belgium_East Flanders	high
Belgium_Flemish Brabant	high
Belgium_Hainaut	high
Belgium_Liege	high
Belgium_Limburg	high
Belgium_Luxembourg	high
Belgium_Namur	high
Belgium_Walloon Brabant	high
Belgium_West Flanders	high
Belize	normal
Benin	normal
Bermuda	high
Bhutan	extra_small
Bolivia_North	poor
Bolivia_South	poor
Bosnia and Herzegovina_Brcko district of Bosnia and Herzegowina	high
Bosnia and Herzegovina_Entity Federation of Bosnia and Herzegovina	normal
Bosnia and Herzegovina_Republic of Srpska	normal
Botswana	poor
Brazil_Bahia	poor
Brazil_Goias_Brasilia	small
Brazil_Goias_North	extra_small
Brazil_Mato Grosso Do Sul	poor
Brazil_Mato Grosso	small
Brazil_Northeast Region_East	normal
Brazil_Northeast Region_West	poor
Brazil_North Region_East	small
Brazil_North Region_West	small
Brazil_Paraiba	normal
Brazil_Parana_East	normal
Brazil_Parana_West	normal
Brazil_Rio Grande do Norte	normal
Brazil_Santa Catarina	small
Brazil_Southeast Region_Espirito Santo	small
Brazil_Southeast Region_Minas Gerais_Contagem	extra_small
Brazil_Southeast Region_Minas Gerais_North	poor
Brazil_Southeast Region_Rio de Janeiro	normal
Brazil_Southeast Region_Sao Paulo_Campinas	normal
Brazil_Southeast Region_Sao Paulo_City	normal
Brazil_Southeast Region_Sao Paulo_West	normal
Brazil_South Region_East	normal
Brazil_South Region_West	small
British Indian Ocean Territory	high
British Virgin Islands	high
Brunei	high
Bulgaria_East	normal
Bulgaria_West	normal
Burkina Faso	extra_small
Burundi	normal
Cambodia	small
Cameroon_Central	small
Cameroon_West	small
Campo de Hielo Sur	high
Canada_Alberta_Edmonton	extra_small
Canada_Alberta_North	extra_small
Canada_Alberta_South	normal
Canada_British Columbia_Central	poor
Canada_British Columbia_Far_North	normal
Canada_British Columbia_Islands	normal
Canada_British Columbia_Northeast	poor
Canada_British Columbia_North	poor
Canada_British Columbia_Southeast	poor
Canada_British Columbia_Vancouver	small
Canada_Labrador_North	small
Canada_Labrador_South	normal
Canada_Labrador_West	normal
Canada_Manitoba_Northeast	small
Canada_Manitoba_Northwest	normal
Canada_Manitoba_South	normal
Canada_Manitoba_Winnipeg	normal
Canada_New Brunswick	normal
Canada_Newfoundland_East	normal
Canada_Newfoundland_North	normal
Canada_Newfoundland_South	high_f2
Canada_Newfoundland_West	normal
Canada_Northwest Territories_East	poor
Canada_Northwest Territories_North	poor
Canada_Northwest Territories_Yellowknife	extra_small
Canada_Nova Scotia_Halifax	normal
Canada_Nova Scotia_Sydney	high_f2
Canada_Nunavut_North	small
Canada_Nunavut_South	small
Canada_Ontario_Bame	high_f2
Canada_Ontario_Kingston	high_f2
Canada_Ontario_London	high
Canada_Ontario_Northeastern_Central	normal
Canada_Ontario_Northeastern_North	normal
Canada_Ontario_Northeastern_SE	normal
Canada_Ontario_Northeastern_S	high
Canada_Ontario_Northeastern_SW	high_f2
Canada_Ontario_Northeastern_Wawa	normal
Canada_Ontario_Northern	normal
Canada_Ontario_Northwestern	extra_small
Canada_Ontario_Toronto	high
Canada_Prince Edward Island	high
Canada_Quebec_Quebec	normal
Canada_Quebek_Far North	poor
Canada_Quebek_Lachute	normal
Canada_Quebek_Montreal	high
Canada_Quebek_North	extra_small
Canada_Quebek_Southeast_Rimouski	normal
Canada_Quebek_Southeast_Saguenay	normal
Canada_Quebek_West_Chibougamau	normal
Canada_Quebek_West_Rouyn-Noranda	normal
Canada_Saskatchewan_North	extra_small
Canada_Saskatchewan_Regina	normal
Canada_Saskatchewan_Saskatoon	normal
Canada_Yukon_North	poor
Canada_Yukon_Whitehorse	extra_small
Cape Verde	high
Caribisch Nederland	high
Cayman Islands	high
Central African Republic	poor
Chad	poor
Chile_Central	small
Chile_North	poor
Chile_South	small
China_Anhui	extra_small
China_Chongqing	extra_small
China_Fujian	poor
China_Gansu	small
China_Guangdong	small
China_Guangxi	poor
China_Guizhou	poor
China_Hebei	poor
China_Heilongjiang	poor
China_Henan	extra_small
China_Hubei	poor
China_Hunan	poor
China_Inner Mongolia	poor
China_Jiangsu	normal
China_Jiangxi	poor
China_Jilin	extra_small
China_Liaoning	extra_small
China_Ningxia Hui	normal
China_Qinghai	poor
China_Shaanxi	poor
China_Shandong	small
China_Shanghai	high
China_Shanxi	poor
China_Sichuan	small
China_Tibet Autonomous Region	small
China_Xinjiang	small
China_Yunnan	poor
China_Zhejiang	extra_small
Colombia_East	small
Colombia_North	poor
Colombia_West	poor
Comoros	high
Congo-Brazzaville	poor
Congo-Kinshasa_Kivu	extra_small
Congo-Kinshasa_West	small
Cook Islands	high
Costa Rica	small
Cote dIvoire	poor
Crimea	high
Croatia_Central	high_f2
Croatia_West	normal
Cuba	normal
Cyprus	high
Czech_Jihovychod_Jihomoravsky kraj	high
Czech_Jihovychod_Kraj Vysocina	high
Czech_Jihozapad_Jihocesky kraj	high
Czech_Jihozapad_Plzensky kraj	high
Czech_Karlovasky kraj	high
Czech_Moravskoslezsko	high
Czech_Olomoucky kraj	high
Czech_Praha	high
Czech_Severovychod_Kralovehradecky kraj	high
Czech_Severovychod_Liberecky kraj	high
Czech_Severovychod_Pardubicky kraj	high
Czech_Stredni Cechy_East	high
Czech_Stredni Cechy_West	high
Czech_Ustecky kraj	high
Czech_Zlinsky Kraj	high
Denmark_Capital Region of Denmark	high
Denmark_Central Denmark Region	high
Denmark_North Denmark Region	high
Denmark_Region of Southern Denmark	high
Denmark_Region Zealand	high
Djibouti	normal
Dominica	high
Dominican Republic	normal
East Timor	normal
Ecuador_East	poor
Ecuador_West	small
Egypt	small
El Salvador	normal
Equatorial Guinea	normal
Eritrea	extra_small
Estonia_East	high
Estonia_West	high
Ethiopia	poor
Falkland Islands	high
Faroe Islands	high
Federated States of Micronesia	high
Fiji	normal
Finland_Eastern Finland_North	normal
Finland_Eastern Finland_South	high_f2
Finland_Northern Finland	extra_small
Finland_Southern Finland_Helsinki	high
Finland_Southern Finland_Lappeenranta	high
Finland_Southern Finland_West	high
Finland_Western Finland_Jyvaskyla	high_f2
Finland_Western Finland_Tampere	normal
France_Alsace_Bas-Rhin	high
France_Alsace_Haut-Rhin	high
France_Aquitaine_Dordogne	high
France_Aquitaine_Gironde	high
France_Aquitaine_Landes	high
France_Aquitaine_Lot-et-Garonne	high
France_Aquitaine_Pyrenees-Atlantiques	high
France_Auvergne_Allier	high
France_Auvergne_Cantal	high
France_Auvergne_Haute-Loire	high
France_Auvergne_Puy-de-Dome	high
France_Brittany_Cotes-dArmor	high
France_Brittany_Finistere	high
France_Brittany_Ille-et-Vilaine	high
France_Brittany_Morbihan	high
France_Burgundy_Cote-dOr	high
France_Burgundy_Nievre	high
France_Burgundy_Saone-et-Loire	high
France_Burgundy_Yonne	high
France_Centre-Val de Loire_Cher	high
France_Centre-Val de Loire_Eure-et-Loir	high
France_Centre-Val de Loire_Indre-et-Loire	high
France_Centre-Val de Loire_Indre	high
France_Centre-Val de Loire_Loir-et-Cher	high
France_Centre-Val de Loire_Loiret	high
France_Champagne-Ardenne	high
France_Corsica	normal
France_Free County_North	high
France_Free County_South	high
France_French Guiana	small
France_Ile-de-France_Essonne	high
France_Ile-de-France_Hauts-de-Seine	high
France_Ile-de-France_Paris	high
France_Ile-de-France_Seine-et-Marne	high
France_Ile-de-France_Seine-Saint-Denis	high
France_Ile-de-France_Val-de-Marne	high
France_Ile-de-France_Val-dOise	high
France_Ile-de-France_Yvelines	high
France_Languedoc-Roussillon_Aude	high
France_Languedoc-Roussillon_Gard	high
France_Languedoc-Roussillon_Herault	high
France_Languedoc-Roussillon_Lozere	high
France_Languedoc-Roussillon_Pyrenees-Orientales	high
France_Limousin	high
France_Lorraine_Meurthe-et-Moselle	high
France_Lorraine_Meuse	high
France_Lorraine_Moselle	high
France_Lorraine_Vosges	high
France_Lower Normandy_Calvados	high
France_Lower Normandy_Manche	high
France_Lower Normandy_Orne	high
France_Midi-Pyrenees_Ariege	high
France_Midi-Pyrenees_Aveyron	high
France_Midi-Pyrenees_Gers	high
France_Midi-Pyrenees_Haute-Garonne	high
France_Midi-Pyrenees_Hautes-Pyrenees	high
France_Midi-Pyrenees_Lot	high
France_Midi-Pyrenees_Tarn-et-Garonne	high
France_Midi-Pyrenees_Tarn	high
France_New Caledonia	normal
France_Nord-Pas-de-Calais_Lille	high
France_Nord-Pas-de-Calais_Nord	high
France_Nord-Pas-de-Calais_Pas-de-Calais	high
France_Pays de la Loire_Loire-Atlantique_Nantes	high
France_Pays de la Loire_Loire-Atlantique_Saint-Nazaire	high
France_Pays de la Loire_Maine-et-Loire	high
France_Pays de la Loire_Mayenne	high
France_Pays de la Loire_Sarthe	high
France_Pays de la Loire_Vendee	high
France_Picardy_Aisne	high
France_Picardy_Oise	high
France_Picardy_Somme	high
France_Poitou-Charentes_Charente	high
France_Poitou-Charentes_Charente-Maritime	high
France_Poitou-Charentes_Deux-Sevres	high
France_Poitou-Charentes_Vienne	high
France_Provence-Alpes-Cote dAzur_Alpes-de-Haute-Provence	normal
France_Provence-Alpes-Cote dAzur_Bouches-du-Rhone	high
France_Provence-Alpes-Cote dAzur_Hautes-Alpes	normal
France_Provence-Alpes-Cote dAzur_Maritime Alps	high
France_Provence-Alpes-Cote dAzur_Var	high
France_Provence-Alpes-Cote dAzur_Vaucluse	high
France_Rhone-Alpes_Ain	high
France_Rhone-Alpes_Ardeche	high
France_Rhone-Alpes_Drome	high
France_Rhone-Alpes_Haute-Savoie	high
France_Rhone-Alpes_Isere	high
France_Rhone-Alpes_Loire	high
France_Rhone-Alpes_Rhone	high
France_Rhone-Alpes_Savoie	high_f2
France_Southern Islands	normal
France_Upper Normandy	high
French Polynesia	high
Gabon	poor
Georgia	small
Germany_Baden-Wurttemberg_Regierungsbezirk Freiburg	high
Germany_Baden-Wurttemberg_Regierungsbezirk Karlsruhe	high
Germany_Baden-Wurttemberg_Regierungsbezirk Stuttgart_Heilbronn	high
Germany_Baden-Wurttemberg_Regierungsbezirk Stuttgart_Stuttgart	high
Germany_Baden-Wurttemberg_Regierungsbezirk Tubingen	high
Germany_Berlin	high
Germany_Brandenburg_North	high
Germany_Brandenburg_South	high
Germany_Free State of Bavaria_Lower Bavaria	high
Germany_Free State of Bavaria_Lower Franconia	high
Germany_Free State of Bavaria_Middle Franconia	high
Germany_Free State of Bavaria_Swabia	high
Germany_Free State of Bavaria_Upper Bavaria_East	high
Germany_Free State of Bavaria_Upper Bavaria_Ingolstadt	high
Germany_Free State of Bavaria_Upper Bavaria_Munchen	high
Germany_Free State of Bavaria_Upper Bavaria_South	high
Germany_Free State of Bavaria_Upper Franconia	high
Germany_Free State of Bavaria_Upper Palatinate	high
Germany_Hamburg_main	high
Germany_Hesse_Regierungsbezirk Darmstadt	high
Germany_Hesse_Regierungsbezirk Giessen	high
Germany_Hesse_Regierungsbezirk Kassel	high
Germany_Lower Saxony_Braunschweig	high
Germany_Lower Saxony_Bremen_Bremen	high
Germany_Lower Saxony_Bremen_Munster	high
Germany_Lower Saxony_Hannover	high
Germany_Lower Saxony_Oldenburg	high
Germany_Mecklenburg-Vorpommern	high
Germany_North Rhine-Westphalia_Regierungsbezirk Arnsberg_Arnsberg	high
Germany_North Rhine-Westphalia_Regierungsbezirk Arnsberg_Dortmund	high
Germany_North Rhine-Westphalia_Regierungsbezirk Detmold	high
Germany_North Rhine-Westphalia_Regierungsbezirk Dusseldorf_Dusseldorf	high
Germany_North Rhine-Westphalia_Regierungsbezirk Dusseldorf_Mulheim	high
Germany_North Rhine-Westphalia_Regierungsbezirk Dusseldorf_Wesel	high
Germany_North Rhine-Westphalia_Regierungsbezirk Koln_Aachen	high
Germany_North Rhine-Westphalia_Regierungsbezirk Koln_Koln	high
Germany_North Rhine-Westphalia_Regierungsbezirk Munster_Munster	high
Germany_North Rhine-Westphalia_Regierungsbezirk Munster_Recklinghausen	high
Germany_Rhineland-Palatinate_Koblenz	high
Germany_Rhineland-Palatinate_South	high
Germany_Saarland	high
Germany_Saxony-Anhalt_Halle	high
Germany_Saxony-Anhalt_Magdeburg	high
Germany_Saxony_Dresden	high
Germany_Saxony_Leipzig	high
Germany_Schleswig-Holstein_Flensburg	high
Germany_Schleswig-Holstein_Kiel	high
Germany_Thuringia	high
Ghana	extra_small
Gibraltar	high
Greece_Decentralized Administration of Aegean	normal
Greece_Decentralized Administration of Attica	high
Greece_Decentralized Administration of Crete	normal
Greece_Decentralized Administration of Epirus - Western Macedonia	normal
Greece_Decentralized Administration of Macedonia and Thrace	normal
Greece_Decentralized Administration of Thessaly - Central Greece	normal
Greece_Decentralized Administration of West Greece	normal
Greenland	extra_small
Grenada	high
Guadeloupe	high
Guatemala	extra_small
Guernsey	high
Guinea-Bissau	high
Guinea	extra_small
Guyana	extra_small
Haiti	normal
Honduras	extra_small
Hungary_Kozep-Magyarorszag	high
Hungary_Northern Great Plain	high_f2
Hungary_Transdanubia	high_f2
Iceland	small
India_Andaman and Nicobar Islands	high
India_Andhra Pradesh	small
India_Arunachal Pradesh	poor
India_Assam	small
India_Bihar	normal
India_Chandigarh	high
India_Chhattisgarh	small
India_Delhi	high
India_Goa	high
India_Gujarat	small
India_Haryana	normal
India_Himachal Pradesh	extra_small
India_Jammu and Kashmir	poor
India_Jharkhand	normal
India_Karnataka_North	small
India_Karnataka_South	normal
India_Kerala	normal
India_Lakshadweep	high
India_Madhya Pradesh	poor
India_Maharashtra	extra_small
India_Manipur	normal
India_Meghalaya	normal
India_Mizoram	normal
India_Nagaland	normal
India_Odisha	extra_small
India_Punjab	normal
India_Rajasthan	poor
India_Sikkim	normal
India_Tamil Nadu	normal
India_Telangana	normal
India_Tripura	high
India_Uttarakhand	extra_small
India_Uttar Pradesh	extra_small
India_West Bengal	normal
Indonesia_Central	small
Indonesia_East	poor
Indonesia_Jawa Barat	normal
Indonesia_Jawa Tengah	normal
Indonesia_Jawa Timur	normal
Indonesia_Nusa Tenggara	normal
Indonesia_West	small
Iran_East	small
Iran_North	poor
Iran_South	poor
Iraq_North	small
Iraq_South	small
Ireland_Connacht	high
Ireland_Leinster	high
Ireland_Munster	high
Ireland_Northern Counties	high
Isle of Man	high
Israel	high
Italy_Abruzzo	normal
Italy_Aosta Valley	high_f2
Italy_Apulia	high
Italy_Basilicata	high_f2
Italy_Calabria	normal
Italy_Campania	high
Italy_Emilia-Romagna_Bologna	high
Italy_Emilia-Romagna_Ferrara	high
Italy_Emilia-Romagna_Forli-Cesena	high
Italy_Emilia-Romagna_Modena	high
Italy_Emilia-Romagna_Parma	high
Italy_Emilia-Romagna_Piacenza	high
Italy_Emilia-Romagna_Ravenna	high
Italy_Emilia-Romagna_Reggio Emilia	high
Italy_Emilia-Romagna_Rimini	high
Italy_Friuli-Venezia Giulia_Gorizia	high
Italy_Friuli-Venezia Giulia_Pordenone	high
Italy_Friuli-Venezia Giulia_Trieste	high
Italy_Friuli-Venezia Giulia_Udine	high
Italy_Lazio	high_f2
Italy_Liguria	high
Italy_Lombardy_Bergamo	high
Italy_Lombardy_Brescia	high
Italy_Lombardy_Como	high
Italy_Lombardy_Cremona	high
Italy_Lombardy_Lecco	high
Italy_Lombardy_Lodi	high
Italy_Lombardy_Mantua	high
Italy_Lombardy_Milan	high
Italy_Lombardy_Monza and Brianza	high
Italy_Lombardy_Pavia	high
Italy_Lombardy_Sondrio	high_f2
Italy_Lombardy_Varese	high
Italy_Marche	high_f2
Italy_Molise	high
Italy_Piemont_Alessandria	high
Italy_Piemont_Asti	high
Italy_Piemont_Biella	high
Italy_Piemont_Cuneo	high
Italy_Piemont_Novara	high
Italy_Piemont_Torino	high
Italy_Piemont_Verbano-Cusio-Ossola	high
Italy_Piemont_Vercelli	high
Italy_Sardinia	normal
Italy_Sicily	normal
Italy_Trentino-Alto Adige Sudtirol	normal
Italy_Tuscany_Grosseto	high
Italy_Tuscany_Massa e Carrara	high
Italy_Umbria	high_f2
Italy_Veneto_Belluno	high_f2
Italy_Veneto_Padova	high
Italy_Veneto_Rovigo	high
Italy_Veneto_Treviso	high
Italy_Veneto_Venezia	high
Italy_Veneto_Verona	high
Italy_Veneto_Vicenza	high
Jamaica	normal
Japan_Chubu Region_Aichi_Nagoya	high
Japan_Chubu Region_Aichi_Toyohashi	high
Japan_Chubu Region_Fukui	high
Japan_Chubu Region_Gifu	normal
Japan_Chubu Region_Ishikawa	high
Japan_Chubu Region_Nagano	normal
Japan_Chubu Region_Niigata	normal
Japan_Chubu Region_Shizuoka	high
Japan_Chubu Region_Toyama	high
Japan_Chubu Region_Yamanashi	high_f2
Japan_Chugoku Region_Hiroshima	high
Japan_Chugoku Region_Okayama	high_f2
Japan_Chugoku Region_Shimane	high_f2
Japan_Chugoku Region_Tottori	high
Japan_Chugoku Region_Yamaguchi	high_f2
Japan_Hokkaido Region_East	normal
Japan_Hokkaido Region_North	normal
Japan_Hokkaido Region_Sapporo	normal
Japan_Hokkaido Region_West	normal
Japan_Kanto_Chiba	high
Japan_Kanto_Gunma	high_f2
Japan_Kanto_Ibaraki	high
Japan_Kanto_Kanagawa	high
Japan_Kanto_Saitama	high
Japan_Kanto_Tochigi	high
Japan_Kanto_Tokyo	high
Japan_Kinki Region_Mie	high_f2
Japan_Kinki Region_Nara	high
Japan_Kinki Region_Osaka_Osaka	high
Japan_Kinki Region_Osaka_West	high_f2
Japan_Kinki Region_Wakayama	high_f2
Japan_Kyushu Region_Fukuoka	high
Japan_Kyushu Region_Kagoshima	normal
Japan_Kyushu Region_Kumamoto	high_f2
Japan_Kyushu Region_Miyazaki	normal
Japan_Kyushu Region_Nagasaki	high
Japan_Kyushu Region_Oita	high_f2
Japan_Kyushu Region_Okinawa	high
Japan_Kyushu Region_Saga	high
Japan_Shikoku Region_Ehime	high_f2
Japan_Shikoku Region_Kagawa	high
Japan_Shikoku Region_Kochi	normal
Japan_Shikoku Region_Kyoto	high
Japan_Shikoku Region_Tokushima	high
Japan_Tohoku_Akita	normal
Japan_Tohoku_Aomori	normal
Japan_Tohoku_Fukushima	normal
Japan_Tohoku_Iwate	normal
Japan_Tohoku_Miyagi	high
Japan_Tohoku_Yamagata	normal
Jersey	high
Jerusalem	high
Jordan	normal
Kazakhstan_North	poor
Kazakhstan_South	small
Kenya	small
Kingdom of Lesotho	normal
Kiribati	high
Kuwait	high_f2
Kyrgyzstan	poor
Laos	poor
Latvia	normal
Lebanon	normal
Liberia	small
Libya	small
Liechtenstein	high
Lithuania_East	high_f2
Lithuania_West	high
Luxembourg	high
Macedonia	normal
Madagascar	small
Malawi	normal
Malaysia	small
Maldives	high
Mali	small
Malta	high
Marshall Islands	high
Martinique	high
Mauritania	poor
Mauritius	high
Mexico_California	extra_small
Mexico_Central_East	poor
Mexico_Central_West	poor
Mexico_Chihuahua	poor
Mexico_East	poor
Mexico_Mexico	small
Mexico_Sonora	poor
Mexico_South	poor
Moldova	normal
Monaco	high
Mongolia	small
Montenegro	normal
Montserrat	high
Morocco_Doukkala-Abda	normal
Morocco_Rabat-Sale-Zemmour-Zaer	normal
Morocco_Southern	poor
Morocco_Western Sahara	poor
Mozambique	small
Myanmar	small
Nagorno-Karabakh	normal
Namibia	small
Nauru	high
Nepal_Kathmandu	normal
Nepal_Madhyamanchal	normal
Nepal_Purwanchal	normal
Nepal_West	poor
Netherlands_Drenthe	high
Netherlands_Flevoland	high
Netherlands_Friesland	high
Netherlands_Gelderland_Nijmegen	high
Netherlands_Gelderland_North	high
Netherlands_Gelderland_Zutphen	high
Netherlands_Groningen	high
Netherlands_Limburg	high
Netherlands_North Brabant_Eindhoven	high
Netherlands_North Brabant_Roosendaal	high
Netherlands_North Brabant_Tiburg	high
Netherlands_North Brabant_Uden	high
Netherlands_North Holland_Alkmaar	high
Netherlands_North Holland_Amsterdam	high
Netherlands_North Holland_Zaandam	high
Netherlands_Overijssel_Enschede	high
Netherlands_Overijssel_Zwolle	high
Netherlands_South Holland_Brielle	high
Netherlands_South Holland_Den Haag	high
Netherlands_South Holland_Leiden	high
Netherlands_South Holland_Rotterdam	high
Netherlands_Utrecht_Amersfoort	high
Netherlands_Utrecht_Utrecht	high
Netherlands_Zeeland	high
New Zealand North_Auckland	normal
New Zealand North_Wellington	normal
New Zealand South_Canterbury	small
New Zealand South_Southland	small
Nicaragua	extra_small
Nigeria_North	poor
Nigeria_South	small
Niger	poor
Niue	high
North Korea	poor
Norway_Bouvet Island	high
Norway_Central	high_f2
Norway_Hedmark	normal
Norway_Hordaland	normal
Norway_Jan Mayen	high
Norway_Nordland	normal
Norway_Northern	small
Norway_North Trondelag	normal
Norway_Oppland	normal
Norway_Rogaland	normal
Norway_Southern	normal
Norway_South Trondelag	normal
Norway_Svalbard	poor
Norway_Western	normal
Oman	poor
Pakistan	poor
Palau	high
Palestine	high
Panama	small
Papua New Guinea	poor
Paraguay	extra_small
Peru_Lima	poor
Peru_North	poor
Peru_South	poor
Philippines_Luzon_Manila	normal
Philippines_Luzon_North	small
Philippines_Luzon_South	normal
Philippines_Mindanao	small
Philippines_Visayas	normal
Pitcairn Islands	high
Poland_Greater Poland Voivodeship	high
Poland_Kuyavian-Pomeranian Voivodeship	high
Poland_Lesser Poland Voivodeship	high
Poland_Lodz Voivodeship	high
Poland_Lower Silesian Voivodeship	high
Poland_Lublin Voivodeship	high
Poland_Lubusz Voivodeship	high
Poland_Masovian Voivodeship	high_f2
Poland_Opole Voivodeship	high
Poland_Podlaskie Voivodeship	high
Poland_Pomeranian Voivodeship	high
Poland_Silesian Voivodeship	high
Poland_Subcarpathian Voivodeship	high
Poland_Swietokrzyskie Voivodeship	high
Poland_Warmian-Masurian Voivodeship	high
Poland_West Pomeranian Voivodeship	high
Portugal_Islands	high
Portugal_Porto	high
Portugal_South	normal
Portugal_Viseu	normal
Qatar	high
Republic of Kosovo	normal
Romania_Centre	normal
Romania_North_East	normal
Romania_North_West	normal
Romania_South_East	normal
Romania_South	high_f2
Romania_South_West	normal
Romania_West	normal
Russia_Altai Krai	small
Russia_Altai Republic	extra_small
Russia_Amur Oblast	poor
Russia_Arkhangelsk Oblast_Central	extra_small
Russia_Arkhangelsk Oblast_North	poor
Russia_Astrakhan Oblast	high
Russia_Bashkortostan	small
Russia_Belgorod Oblast	normal
Russia_Bryansk Oblast	normal
Russia_Buryatia	poor
Russia_Chechen Republic	normal
Russia_Chelyabinsk Oblast	normal
Russia_Chukotka Autonomous Okrug	small
Russia_Chuvashia	high
Russia_Ingushetia	high
Russia_Irkutsk Oblast	poor
Russia_Ivanovo Oblast	high
Russia_Jewish Autonomous Oblast	normal
Russia_Kabardino-Balkaria	normal
Russia_Kaliningrad Oblast	high
Russia_Kaluga Oblast	high_f2
Russia_Kamchatka Krai	poor
Russia_Karachay-Cherkessia	normal
Russia_Kemerov Oblast	small
Russia_Khabarovsk Krai	small
Russia_Khakassia	small
Russia_Kirov Oblast	normal
Russia_Komi Republic	poor
Russia_Kostroma Oblast	normal
Russia_Krasnodar Krai_Adygeya	normal
Russia_Krasnodar Krai	normal
Russia_Krasnoyarsk Krai_North	small
Russia_Krasnoyarsk Krai_South	poor
Russia_Kurgan Oblast	normal
Russia_Kursk Oblast	high
Russia_Leningradskaya Oblast_Karelsky	high
Russia_Leningradskaya Oblast_Southeast	normal
Russia_Lipetsk Oblast	high_f2
Russia_Magadan Oblast	poor
Russia_Mari El	high
Russia_Moscow	high
Russia_Moscow Oblast_East	high
Russia_Moscow Oblast_West	high
Russia_Murmansk Oblast	extra_small
Russia_Nenets Autonomous Okrug	extra_small
Russia_Nizhny Novgorod Oblast	normal
Russia_North Ossetia-Alania	normal
Russia_Novgorod Oblast	normal
Russia_Novosibirsk Oblast	normal
Russia_Omsk Oblast	normal
Russia_Orenburg Oblast	normal
Russia_Oryol Oblast	high_f2
Russia_Penza Oblast	normal
Russia_Perm Krai_North	small
Russia_Perm Krai_South	normal
Russia_Primorsky Krai	poor
Russia_Pskov Oblast	normal
Russia_Republic of Dagestan	small
Russia_Republic of Kalmykia	normal
Russia_Republic of Karelia_North	small
Russia_Republic of Karelia_South	normal
Russia_Republic of Mordovia	high
Russia_Rostov Oblast	normal
Russia_Ryazan Oblast	normal
Russia_Saint Petersburg	high
Russia_Sakhalin Oblast	small
Russia_Sakha Republic	small
Russia_Samara Oblast	high_f2
Russia_Saratov Oblast	normal
Russia_Smolensk Oblast	normal
Russia_Stavropol Krai	normal
Russia_Sverdlovsk Oblast_Ekaterinburg	normal
Russia_Sverdlovsk Oblast_North	normal
Russia_Tambov Oblast	high
Russia_Tatarstan	normal
Russia_Tomsk Oblast	small
Russia_Tula Oblast	high_f2
Russia_Tuva	poor
Russia_Tver Oblast	normal
Russia_Tyumen Oblast	normal
Russia_Udmurt Republic	normal
Russia_Ulyanovsk Oblast	high_f2
Russia_Vladimir Oblast	high
Russia_Volgograd Oblast	normal
Russia_Vologda Oblast	small
Russia_Voronezh Oblast	high_f2
Russia_Yamalo-Nenets Autonomous Okrug	poor
Russia_Yaroslavl Oblast	high_f2
Russia_Yugra_Khanty	poor
Russia_Yugra_Surgut	small
Russia_Zabaykalsky Krai	poor
Rwanda	normal
Sahrawi Arab Democratic Republic	normal
Saint Barthelemy	high
Saint Helena Ascension and Tristan da Cunha	high
Saint Kitts and Nevis	high
Saint Lucia	high
Saint Martin	high
Saint Vincent and the Grenadines	high
Samoa	high
San Marino	high
Sao Tome and Principe	high
Saudi Arabia_North	poor
Saudi Arabia_South	poor
Senegal	extra_small
Serbia	normal
Seychelles	high
Sierra Leone	normal
Singapore	high
Slovakia_Region of Banska Bystrica	high
Slovakia_Region of Bratislava	high
Slovakia_Region of Kosice	high
Slovakia_Region of Nitra	high
Slovakia_Region of Presov	high_f2
Slovakia_Region of Trencin	high
Slovakia_Region of Trnava	high
Slovakia_Region of Zilina	high
Slovenia_East	high
Slovenia_West	high
Solomon Islands	normal
Somalia	poor
South Africa_Eastern Cape	extra_small
South Africa_Free State	normal
South Africa_Gauteng	high
South Africa_KwaZulu-Natal	small
South Africa_Limpopo	small
South Africa_Mpumalanga	normal
South Africa_Northern Cape	poor
South Africa_North West	normal
South Africa_Western Cape	small
South Georgia and the South Sandwich Islands	high
South Korea_North	normal
South Korea_South	normal
South Ossetia	high
South Sudan	poor
Spain_Andalusia_Granada	normal
Spain_Andalusia_Sevilla	normal
Spain_Aragon	normal
Spain_Balearic Islands	high
Spain_Basque Country	high
Spain_Canary Islands	high
Spain_Cantabria	high
Spain_Castile and Leon_East	normal
Spain_Castile and Leon_West	normal
Spain_Castile-La Mancha	normal
Spain_Catalonia_Provincia de Barcelona	high
Spain_Catalonia_Provincia de Girona	high
Spain_Catalonia_Provincia de Lleida	normal
Spain_Catalonia_Provincia de Tarragona	high
Spain_Ceuta	high
Spain_Community of Madrid	high
Spain_Comunidad Foral de Navarra	high_f2
Spain_Extremadura	normal
Spain_Galicia_North	high
Spain_Galicia_South	normal
Spain_La Rioja	high
Spain_Melilla	high
Spain_Principado de Asturias	normal
Spain_Region de Murcia	high
Spain_Valencian Community	normal
Sri Lanka	normal
Sudan_East	poor
Sudan_West	poor
Suriname	extra_small
Swaziland	normal
Sweden_Bergslagen	normal
Sweden_Malardalen	high
Sweden_Mellannorrland	normal
Sweden_Norra Sverige	poor
Sweden_Ostra Gotaland	normal
Sweden_Sodra Gotaland	high
Sweden_Stockholm	high
Sweden_Vastra Gotaland	high_f2
Switzerland_Central	high
Switzerland_Eastern	normal
Switzerland_Espace Mittelland_Bern	high
Switzerland_Espace Mittelland_East	high
Switzerland_Lake Geneva region	high_f2
Switzerland_Northwestern	high
Switzerland_Ticino	high
Switzerland_Zurich	high
Syria	small
Taiwan_North	high_f2
Taiwan_South	normal
Tajikistan	poor
Tanzania	normal
Thailand_Central	extra_small
Thailand_North	extra_small
Thailand_South	small
The Bahamas	high
The Gambia	high
Togo	normal
Tokelau	high
Tonga	high
Trinidad and Tobago	high
Tunisia	small
Turkey_Aegean Region	small
Turkey_Black Sea Region	extra_small
Turkey_Central Anatolia Region_Ankara	small
Turkey_Central Anatolia Region_Kayseri	small
Turkey_Eastern Anatolia Region	poor
Turkey_Marmara Region_Bursa	normal
Turkey_Marmara Region_Istanbul	high
Turkey_Mediterranean Region	small
Turkey_Southeastern Anatolia Region	small
Turkmenistan	poor
Turks and Caicos Islands	high
Tuvalu	high
Uganda	small
UK_England_East Midlands	high
UK_England_East of England_Essex	high
UK_England_East of England_Norfolk	high
UK_England_Greater London	high
UK_England_North East England	high
UK_England_North West England_Lancaster	high
UK_England_North West England_Manchester	high
UK_England_South East_Brighton	high
UK_England_South East_Oxford	high
UK_England_South West England_Bristol	high
UK_England_South West England_Cornwall	high
UK_England_West Midlands	high
UK_England_Yorkshire and the Humber	high
UK_Northern Ireland	high
Ukraine_Cherkasy Oblast	high
Ukraine_Chernihiv Oblast	high
Ukraine_Chernivtsi Oblast	high
Ukraine_Dnipropetrovsk Oblast	high
Ukraine_Donetsk Oblast	high
Ukraine_Ivano-Frankivsk Oblast	normal
Ukraine_Kharkiv Oblast	high
Ukraine_Kherson Oblast	high
Ukraine_Khmelnytskyi Oblast	high
Ukraine_Kirovohrad Oblast	high
Ukraine_Kyiv Oblast	high
Ukraine_Luhansk Oblast	high
Ukraine_Lviv Oblast	high
Ukraine_Mykolaiv Oblast	high_f2
Ukraine_Odessa Oblast	normal
Ukraine_Poltava Oblast	high_f2
Ukraine_Rivne Oblast	high
Ukraine_Sumy Oblast	high
Ukraine_Ternopil Oblast	high
Ukraine_Vinnytsia Oblast	high_f2
Ukraine_Volyn Oblast	high
Ukraine_Zakarpattia Oblast	normal
Ukraine_Zaporizhia Oblast	high
Ukraine_Zhytomyr Oblast	high_f2
UK_Scotland_North	normal
UK_Scotland_South	high
UK_Wales	high
United Arab Emirates	normal
United States Virgin Islands	high
Uruguay	small
US_Alabama_Birmingham	normal
US_Alabama_Montgomery	normal
US_Alaska	small
US_Arizona_Flagstaff	small
US_Arizona_Phoenix	normal
US_Arizona_Tucson	small
US_Arkansas_North	normal
US_Arkansas_South	normal
US_California_Bakersfield_Bakersfield	normal
US_California_Bakersfield_Lancaster	small
US_California_Chico	normal
US_California_LA	high
US_California_LA North	high
US_California_Redding	normal
US_California_Sacramento_Fresno	small
US_California_Sacramento_Sacramento	normal
US_California_Sacramento_Stockton	normal
US_California_San Diego	high_f2
US_California_Santa_Clara_Palo Alto	high_f2
US_California_Santa_Clara_Santa Cruz	normal
US_Colorado_Aspen	normal
US_Colorado_Denver	normal
US_Colorado_South	small
US_Connecticut	high
US_Delaware	high
US_Florida_Gainesville	normal
US_Florida_Jacksonville	normal
US_Florida_Miami	high
US_Florida_Orlando	high
US_Florida_Tampa	high_f2
US_Georgia_Atlanta	high
US_Georgia_Macon	normal
US_Georgia_North	normal
US_Georgia_South	normal
US_Guam	high
US_Hawaii	normal
US_Idaho_North	poor
US_Idaho_South	small
US_Illinois_Chickago	high
US_Illinois_Elgin	high
US_Illinois_Rockford	high
US_Illinois_South	normal
US_Illinois_Springfield	normal
US_Indiana_Evansville	normal
US_Indiana_Indianapolis	high
US_Indiana_North	high_f2
US_Iowa_Des Moines	normal
US_Iowa_Waterloo	normal
US_Iowa_West	normal
US_Kansas_East	normal
US_Kansas_West	normal
US_Kansas_Wichita	normal
US_Kentucky_East	normal
US_Kentucky_Louisville	high
US_Kentucky_West	normal
US_Louisiana_Central	normal
US_Louisiana_New Orleans	high
US_Maine	normal
US_Maryland_and_DC	high
US_Maryland_Baltimore	high
US_Massachusetts_Boston	high
US_Massachusetts_Central	high
US_Massachusetts_Plymouth	high
US_Massachusetts_Southeastern	high
US_Massachusetts_West	high
US_Michigan_Detroit	high
US_Michigan_Grand Rapids	normal
US_Michigan_Lansing	normal
US_Michigan_North	normal
US_Minnesota_Minneapolis	high
US_Minnesota_North	normal
US_Minnesota_Rochester	normal
US_Minnesota_Saint Cloud	normal
US_Mississippi_Gulfport	high
US_Mississippi_North	normal
US_Missouri_East	normal
US_Missouri_Kansas	normal
US_Missouri_Springfield	normal
US_Missouri_St Louis	normal
US_Montana_East	poor
US_Montana_West	extra_small
US_Nebraska_East	normal
US_Nebraska_West	small
US_Nevada	poor
US_New Hampshire	normal
US_New Jersey_North	high
US_New Jersey_South	high
US_New Mexico_Albuquerque	small
US_New Mexico_Roswell	extra_small
US_New York_East	high
US_New York_New York	high
US_New York_North	normal
US_New York_West	normal
US_North Carolina_Asheville	normal
US_North Carolina_Charlotte	high
US_North Carolina_Greensboro	high_f2
US_North Carolina_Raleigh	high
US_North Carolina_Wilmington	high_f2
US_North Carolina_Wilson	high_f2
US_North Dakota_Bismarck	normal
US_North Dakota_East	normal
US_North Dakota_Minot	normal
US_Ohio_Cincinnati	high
US_Ohio_Cleveland	normal
US_Ohio_Columbus	normal
US_Ohio_Toledo	high
US_Oklahoma_East	normal
US_Oklahoma_Oklahoma	normal
US_Oklahoma_Tulsa	normal
US_Oklahoma_West	normal
US_Oregon_Eugene	small
US_Oregon_Portland	normal
US_Oregon_West	extra_small
US_Pennsylvania_Central	normal
US_Pennsylvania_Pittsburgh	high_f2
US_Pennsylvania_Reading	high
US_Pennsylvania_Scranton	normal
US_Puerto Rico	high
US_Rhode Island	high
US_South Carolina_Charleston	high
US_South Carolina_Columbia	normal
US_South Carolina_Florence	high_f2
US_South Dakota	small
US_Tennessee_East	normal
US_Tennessee_West	normal
US_Texas_Amarillo	normal
US_Texas_Austin	high
US_Texas_Dallas	high
US_Texas_Houston	high
US_Texas_Lubbock	normal
US_Texas_San Antonio	normal
US_Texas_Southwest	small
US_Texas_Tyler	normal
US_Texas_Victoria	high
US_Texas_Wako	normal
US_Texas_West	normal
US_United States Minor Outlying Islands	high
US_Utah_North	normal
US_Utah_South	extra_small
US_Vermont	normal
US_Virginia_Alexandria	high
US_Virginia_Lynchburg	normal
US_Virginia_Norfolk	high
US_Virginia_Richmond	high
US_Virginia_Roanoke	normal
US_Washington_Coast	normal
US_Washington_Seattle	normal
US_Washington_Yakima	extra_small
US_West Virginia	small
US_Wisconsin_Eau Claire	normal
US_Wisconsin_Madison	normal
US_Wisconsin_Milwaukee	high
US_Wisconsin_North	normal
US_Wyoming	poor
Uzbekistan	poor
Vanuatu	normal
Venezuela_North	poor
Venezuela_South	poor
Vietnam	small
Wallis and Futuna	high
Willis Island	high
Yemen	poor
Zambia	small
Zimbabwe	small
